111111111111111111111111111111111111111111111111111111111111
100000000000000000000000000000000000000000000000000000000001
100000000000000000000000000000000000000000000000000000000001
100000000E00000000000000000000000000000000000000000000000001
100000000000000000000000000000000000000000000C00000000000001
100000000000000000000000000000000000000000000000000000000001
100000000000000000000C00000000000000000000000000000000000001
100000000000000000000000000000000000000000000000C00000000001
100000000000000000000000000000000000000000000000000000000001
100000000000000000000000000000000000000000000000000000000001
111111111111100011111111111111110000011111111111110011111111
111111111100000000111111111000000000000001111110000001111111
11111111111111000000000000000000000000000000000000C000011111
110000000000111100000000000001111111000000000001111111111111
111000000000000000001111110000000000000001111100000000111111
111111111111111111000000000000000111111111111111100011111111
111111111111111111111111111110000000000000000000000000111111
1000000000000000000000000000000000000C0000000000000000000001
100000000000000C00000000000000000000000000000000000000000001
10000000C000000000000000000000000000000000000000000000000001
100000000000000000000011111111111111000000001111111111111111
111111111111110000000001111111111111000111111111111111111111
111111111111111111100000001111100000110011111111111111111111
111111111100000000000000000000000000000000001111111111111111
111111000000000000C00000000000000000000000000000000011111111
111000000000000000000000000000000000C00000000000000000000001
111111111111111000000000000000000000000000000000000000000001
11111000000000000000C000000111111111111111111111111111111111
1110000000000000C0000000000000000000000001111111111111111111
111000000000000000000000000000000000000000000000000001111111
111111111000000000000C00000011111111111111111111111111111111
111111111111110000000000000000000000000000001111111111111111
11111111111111111111000000P111111111111111111111111111111111
111111111111111111111111111111111111111111111111111111111111